!	восклицательный знак
(	левая скобка: [(
)	правая скобка: ])
QO	левая кавычка
QC	правая кавычка
--	тире
,	запятая
.	точка
...	эллипсис
:	двоеточие
;	точка с запятой
?	вопросительный знак
???	неизвестное слово
FO	формула
FW	иностранное слово
AB	сокращение
ABM	аббревиатура (с главным словом м. р.)
ABF	аббревиатура (с главным словом ж. р.)
ABN	аббревиатура (с главным словом ср. р.)
ABP	аббревиатура (с главным словом мн. ч.)
CC	сочинительный союз
CS	подчинительный союз
DCO	количественное числительное, им. п.
DCG	количественное числительное, род. п.
DCD	количественное числительное, дат. п.
DCA	количественное числительное, вин. п.
DCI	количественное числительное, твор. п.
DCR	количественное числительное, предл. п.
DC-DC	количественное числительное (дефисное написание)
DC1MO	количественное числительное один, м. р., им. п.
DC1MG	количественное числительное один, м. р., род. п.
DC1MD	количественное числительное один, м. р., дат. п.
DC1MA	количественное числительное один, м. р., вин. п., неодуш.
DC1MU	количественное числительное один, м. р., вин. п., одуш.
DC1MI	количественное числительное один, м. р., твор. п.
DC1MR	количественное числительное один, м. р., предл. п.
DC1FO	количественное числительное одна, ж. р., им. п.
DC1FG	количественное числительное одна, ж. р., род. п.
DC1FD	количественное числительное одна, ж. р., дат. п.
DC1FA	количественное числительное одна, ж. р., вин. п.
DC1FI	количественное числительное одна, ж. р., твор. п.
DC1FS	количественное числительное одна, ж. р., твор. п. (~ю)
DC1FR	количественное числительное одна, ж. р., предл. п.
DC1NO	количественное числительное одно, ср. р., им. п.
DC1NG	количественное числительное одно, ср. р., род. п.
DC1ND	количественное числительное одно, ср. р., дат. п.
DC1NA	количественное числительное одно, ср. р., вин. п.
DC1NI	количественное числительное одно, ср. р., твор. п.
DC1NR	количественное числительное одно, ср. р., предл. п.
DC1PO	количественное числительное одни, мн. ч., им. п.
DC1PG	количественное числительное одни, мн. ч., род. п.
DC1PD	количественное числительное одни, мн. ч., дат. п.
DC1PA	количественное числительное одни, мн. ч., вин. п., неодуш.
DC1PU	количественное числительное одни, мн. ч., вин. п., одуш.
DC1PI	количественное числительное одни, мн. ч., твор. п.
DC1PR	количественное числительное одни, мн. ч., предл. п.
DC2PO	количественное числительное два, им. п.
DC2PG	количественное числительное два, род. п.
DC2PD	количественное числительное два, дат. п.
DC2PA	количественное числительное два, неодуш.
DC2PU	количественное числительное два, одуш.
DC2PI	количественное числительное два, твор. п.
DC2PR	количественное числительное два, предл. п.
DC2FO	количественное числительное две, ж. р., им. п.
DC2FG	количественное числительное две, ж. р., род. п.
DC2FD	количественное числительное две, ж. р., дат. п.
DC2FA	количественное числительное две, ж. р., вин. п., неодуш.
DC2FU	количественное числительное две, ж. р., вин. п., мн. ч., одуш.
DC2FI	количественное числительное две, ж. р., твор. п.
DC2FR	количественное числительное две, ж. р., предл. п.
DLO	собирательное числительное, им. п.						
DLG	собирательное числительное, род. п.
DLD	собирательное числительное, дат. п.
DLA	собирательное числительное, вин. п., неодуш.
DLU	собирательное числительное, вин. п., одуш.
DLI	собирательное числительное, твор. п.
DLR	собирательное числительное, предл. п.
DL2PO	собирательное числительное оба, мн. ч., им. п.
DL2PG	собирательное числительное оба, мн. ч., род. п.
DL2PD	собирательное числительное оба, мн. ч., дат. п.
DL2PA	собирательное числительное оба, мн. ч., вин. п., неодуш.
DL2PU	собирательное числительное оба, мн. ч., вин. п., одуш.
DL2PI	собирательное числительное оба, мн. ч., твор. п.
DL2PR	собирательное числительное оба, мн. ч., предл. п.
DL2FO	собирательное числительное обе, ж. р., им. п.
DL2FG	собирательное числительное обе, ж. р., род. п.
DL2FD	собирательное числительное обе, ж. р., дат. п.
DL2FA	собирательное числительное обе, ж. р., вин. п., неодуш.
DL2FU	собирательное числительное обе, ж. р., вин. п., одуш.
DL2FI	собирательное числительное обе, ж. р., твор. п.
DL2FR	собирательное числительное обе, ж. р., предл. п.
DOMO	порядковое числительное, м. р., им. п.
DOMG	порядковое числительное, м. р., род. п.
DOMD	порядковое числительное, м. р., дат. п.
DOMA	порядковое числительное, м. р., вин. п., неодуш.
DOMU	порядковое числительное, м. р., вин. п., одуш.
DOMI	порядковое числительное, м. р., твор. п.
DOMR	порядковое числительное, м. р., предл. п.
DOFO	порядковое числительное, ж. р., им. п.
DOFG	порядковое числительное, ж. р., род. п.
DOFD	порядковое числительное, ж. р., дат. п.
DOFA	порядковое числительное, ж. р., вин. п.
DOFI	порядковое числительное, ж. р., твор. п.
DOFS	порядковое числительное, ж. р., твор. п. (~ю)
DOFR	порядковое числительное, ж. р., предл. п.
DONO	порядковое числительное, ср. р., им. п.
DONG	порядковое числительное, ср. р., род. п.
DOND	порядковое числительное, ср. р., дат. п.
DONA	порядковое числительное, ср. р., вин. п.
DONI	порядковое числительное, ср. р., твор. п.
DONR	порядковое числительное, ср. р., предл. п.
DOPO	порядковое числительное, мн. ч., им. п.
DOPG	порядковое числительное, мн. ч., род. п.
DOPD	порядковое числительное, мн. ч., дат. п.
DOPA	порядковое числительное, мн. ч., вин. п., неодуш.
DOPU	порядковое числительное, мн. ч., вин. п., одуш.
DOPI	порядковое числительное, мн. ч., твор. п.
DOPR	порядковое числительное, мн. ч., предл. п.
ING	предлог, род. п.
IND	предлог, дат. п.
INA	предлог, вин. п.
INI	предлог, твор. п.
INR	предлог, предл. п.
IRG	предлог - омограф наречия, род. п.
IRD	предлог - омограф наречия, дат. п.
IRA	предлог - омограф наречия, вин. п.
IRI	предлог - омограф наречия, твор. п.
IRR	предлог - омограф наречия, предл. п.
IVG	предлог - омограф деепричастия, род. п.
IVD	предлог - омограф деепричастия, дат. п.
IVA	предлог - омограф деепричастия, вин. п.
IVI	предлог - омограф деепричастия, твор. п.
IVR	предлог - омограф деепричастия, предл. п.
JSMO	притяжательное прилагательное, м. р., им. п.
JSMG	притяжательное прилагательное, м. р., род. п.
JSMD	притяжательное прилагательное, м. р., дат. п.
JSMA	притяжательное прилагательное, м. р., вин. п., неодуш.
JSMU	притяжательное прилагательное, м. р., вин. п., одуш.
JSMI	притяжательное прилагательное, м. р., твор. п.
JSMR	притяжательное прилагательное, м. р., предл. п.
JSFO	притяжательное прилагательное, ж. р., им. п.
JSFG	притяжательное прилагательное, ж. р., род. п.
JSFD	притяжательное прилагательное, ж. р., дат. п.
JSFA	притяжательное прилагательное, ж. р., вин. п.
JSFI	притяжательное прилагательное, ж. р., твор. п.
JSFS	притяжательное прилагательное, ж. р., твор. п., (~ю)
JSFR	притяжательное прилагательное, ж. р., предл. п.
JSNO	притяжательное прилагательное, ср. р., им. п.
JSNG	притяжательное прилагательное, ср. р., род. п.
JSND	притяжательное прилагательное, ср. р., дат. п.
JSNA	притяжательное прилагательное, ср. р., вин. п.
JSNI	притяжательное прилагательное, ср. р., твор. п.
JSNR	притяжательное прилагательное, ср. р., предл. п.
JSPO	притяжательное прилагательное, мн. ч., им. п.
JSPG	притяжательное прилагательное, мн. ч., род. п.
JSPD	притяжательное прилагательное, мн. ч., дат. п.
JSPA	притяжательное прилагательное, мн. ч., вин. п., неодуш.
JSPU	притяжательное прилагательное, мн. ч., вин. п., одуш.
JSPI	притяжательное прилагательное, мн. ч., твор. п.
JSPR	притяжательное прилагательное, мн. ч., предл. п.
JJHM	краткое прилагательное, м. р.
JJHF	краткое прилагательное, ж. р.
JJHN	краткое прилагательное, ср. р.
JJHP	краткое прилагательное, мн. ч.
JJMO	качественное/относительное прилагательное, м. р., им. п.
JJMG	качественное/относительное прилагательное, м. р., род. п.
JJMD	качественное/относительное прилагательное, м. р., дат. п.
JJMA	качественное/относительное прилагательное, м. р., вин. п., неодуш.
JJMU	качественное/относительное прилагательное, м. р., вин. п., одуш.
JJMI	качественное/относительное прилагательное, м. р., твор. п.
JJMR	качественное/относительное прилагательное, м. р., предл. п.
JJFO	качественное/относительное прилагательное, ж. р., им. п.
JJFG	качественное/относительное прилагательное, ж. р., род. п.
JJFD	качественное/относительное прилагательное, ж. р., дат. п.
JJFA	качественное/относительное прилагательное, ж. р., вин. п.
JJFI	качественное/относительное прилагательное, ж. р., твор. п.
JJFS	качественное/относительное прилагательное, ж. р., твор. п. (~ю)
JJFR	качественное/относительное прилагательное, ж. р., предл. п.
JJNO	качественное/относительное прилагательное, ср. р., им. п.
JJNG	качественное/относительное прилагательное, ср. р., род. п.
JJND	качественное/относительное прилагательное, ср. р., дат. п.
JJNA	качественное/относительное прилагательное, ср. р., вин. п.
JJNI	качественное/относительное прилагательное, ср. р., твор. п.
JJNR	качественное/относительное прилагательное, ср. р., предл. п.
JJPO	качественное/относительное прилагательное, мн. ч., им. п.
JJPG	качественное/относительное прилагательное, мн. ч., род. п.
JJPD	качественное/относительное прилагательное, мн. ч., дат. п.
JJPA	качественное/относительное прилагательное, мн. ч., вин. п., неодуш.
JJPU	качественное/относительное прилагательное, мн. ч., вин. п., одуш.
JJPI	качественное/относительное прилагательное, мн. ч., твор. п.
JJPR	качественное/относительное прилагательное, мн. ч., предл. п.
JJRMO	прилагательное, сравнит. степень, м. р., им. п.
JJRMG	прилагательное, сравнит. степень, м. р., род. п.
JJRMD	прилагательное, сравнит. степень, м. р., дат. п.
JJRMA	прилагательное, сравнит. степень, м. р., вин. п., неодуш.
JJRMU	прилагательное, сравнит. степень, м. р., вин. п., одуш.
JJRMI	прилагательное, сравнит. степень, м. р., твор. п.
JJRMR	прилагательное, сравнит. степень, м. р., предл. п.
JJRFO	прилагательное, сравнит. степень, ж. р., им. п.
JJRFG	прилагательное, сравнит. степень, ж. р., род. п.
JJRFD	прилагательное, сравнит. степень, ж. р., дат. п.
JJRFA	прилагательное, сравнит. степень, ж. р., вин. п.
JJRFI	прилагательное, сравнит. степень, ж. р., твор. п.
JJRFS	прилагательное, сравнит. степень, ж. р., твор. п. (~ю)
JJRFR	прилагательное, сравнит. степень, ж. р., предл. п.
JJRNO	прилагательное, сравнит. степень, ср. р., им. п.
JJRNG	прилагательное, сравнит. степень, ср. р., род. п.
JJRND	прилагательное, сравнит. степень, ср. р., дат. п.
JJRNA	прилагательное, сравнит. степень, ср. р., вин. п.
JJRNI	прилагательное, сравнит. степень, ср. р., твор. п.
JJRNR	прилагательное, сравнит. степень, ср. р., предл. п.
JJRPO	прилагательное, сравнит. степень, мн. ч., им. п.
JJRPG	прилагательное, сравнит. степень, мн. ч., род. п.
JJRPD	прилагательное, сравнит. степень, мн. ч., дат. п.
JJRPA	прилагательное, сравнит. степень, мн. ч., вин. п., неодуш.
JJRPU	прилагательное, сравнит. степень, мн. ч., вин. п., одуш.
JJRPI	прилагательное, сравнит. степень, мн. ч., твор. п.
JJRPR	прилагательное, сравнит. степень, мн. ч., предл. п.
LARMO	действительное причастие наст. вр., м. р., им. п.
LARMG	действительное причастие наст. вр., м. р., род. п.
LARMD	действительное причастие наст. вр., м. р., дат. п.
LARMA	действительное причастие наст. вр., м. р., вин. п., неодуш.
LARMU	действительное причастие наст. вр., м. р., вин. п., одуш.
LARMI	действительное причастие наст. вр., м. р., твор. п.
LARMR	действительное причастие наст. вр., м. р., предл. п.
LARFO	действительное причастие наст. вр., ж. р., им. п.
LARFG	действительное причастие наст. вр., ж. р., род. п.
LARFD	действительное причастие наст. вр., ж. р., дат. п.
LARFA	действительное причастие наст. вр., ж. р., вин. п.
LARFI	действительное причастие наст. вр., ж. р., твор. п.
LARFS	действительное причастие наст. вр., ж. р., твор. п., (~ю)
LARFR	действительное причастие наст. вр., ж. р., предл. п.
LARNO	действительное причастие наст. вр., ср. р., им. п.
LARNG	действительное причастие наст. вр., ср. р., род. п.
LARND	действительное причастие наст. вр., ср. р., дат. п.
LARNA	действительное причастие наст. вр., ср. р., вин. п.
LARNI	действительное причастие наст. вр., ср. р., твор. п.
LARNR	действительное причастие наст. вр., ср. р., предл. п.
LARPO	действительное причастие наст. вр., мн. ч., им. п.
LARPG	действительное причастие наст. вр., мн. ч., род. п.
LARPD	действительное причастие наст. вр., мн. ч., дат. п.
LARPA	действительное причастие наст. вр., мн. ч., вин. п., неодуш.
LARPU	действительное причастие наст. вр., мн. ч., вин. п., одуш.
LARPI	действительное причастие наст. вр., мн. ч., твор. п.
LARPR	действительное причастие наст. вр., мн. ч., предл. п.
LARLMO	действительное причастие наст. вр., возвратное, м. р., им. п.
LARLMG	действительное причастие наст. вр., возвратное, м. р., род. п.
LARLMD	действительное причастие наст. вр., возвратное, м. р., дат. п.
LARLMA	действительное причастие наст. вр., возвратное, м. р., вин. п., неодуш.
LARLMU	действительное причастие наст. вр., возвратное, м. р., вин. п., одуш.
LARLMI	действительное причастие наст. вр., возвратное, м. р., твор. п.
LARLMR	действительное причастие наст. вр., возвратное, м. р., предл. п.
LARLFO	действительное причастие наст. вр., возвратное, ж. р., им. п.
LARLFG	действительное причастие наст. вр., возвратное, ж. р., род. п.
LARLFD	действительное причастие наст. вр., возвратное, ж. р., дат. п.
LARLFA	действительное причастие наст. вр., возвратное, ж. р., вин. п.
LARLFI	действительное причастие наст. вр., возвратное, ж. р., твор. п.
LARLFS	действительное причастие наст. вр., возвратное, ж. р., твор. п., (~ю)
LARLFR	действительное причастие наст. вр., возвратное, ж. р., предл. п.
LARLNO	действительное причастие наст. вр., возвратное, ср. р., им. п.
LARLNG	действительное причастие наст. вр., возвратное, ср. р., род. п.
LARLND	действительное причастие наст. вр., возвратное, ср. р., дат. п.
LARLNA	действительное причастие наст. вр., возвратное, ср. р., вин. п.
LARLNI	действительное причастие наст. вр., возвратное, ср. р., твор. п.
LARLNR	действительное причастие наст. вр., возвратное, ср. р., предл. п.
LARLPO	действительное причастие наст. вр., возвратное, мн. ч., им. п.
LARLPG	действительное причастие наст. вр., возвратное, мн. ч., род. п.
LARLPD	действительное причастие наст. вр., возвратное, мн. ч., дат. п.
LARLPA	действительное причастие наст. вр., возвратное, мн. ч., вин. п., неодуш.
LARLPU	действительное причастие наст. вр., возвратное, мн. ч., вин. п., одуш.
LARLPI	действительное причастие наст. вр., возвратное, мн. ч., твор. п.
LARLPR	действительное причастие наст. вр., возвратное, мн. ч., предл. п.
LAPMO	действительное причастие прош. вр., м. р., им. п.
LAPMG	действительное причастие прош. вр., м. р., род. п.
LAPMD	действительное причастие прош. вр., м. р., дат. п.
LAPMA	действительное причастие прош. вр., м. р., вин. п., неодуш.
LAPMU	действительное причастие прош. вр., м. р., вин. п., одуш.
LAPMI	действительное причастие прош. вр., м. р., твор. п.
LAPMR	действительное причастие прош. вр., м. р., предл. п.
LAPFO	действительное причастие прош. вр., ж. р., им. п.
LAPFG	действительное причастие прош. вр., ж. р., род. п.
LAPFD	действительное причастие прош. вр., ж. р., дат. п.
LAPFA	действительное причастие прош. вр., ж. р., вин. п.
LAPFI	действительное причастие прош. вр., ж. р., твор. п.
LAPFS	действительное причастие прош. вр., ж. р., твор. п., (~ю)
LAPFR	действительное причастие прош. вр., ж. р., предл. п.
LAPNO	действительное причастие прош. вр., ср. р., им. п.
LAPNG	действительное причастие прош. вр., ср. р., род. п.
LAPND	действительное причастие прош. вр., ср. р., дат. п.
LAPNA	действительное причастие прош. вр., ср. р., вин. п.
LAPNI	действительное причастие прош. вр., ср. р., твор. п.
LAPNR	действительное причастие прош. вр., ср. р., предл. п.
LAPPO	действительное причастие прош. вр., мн. ч., им. п.
LAPPG	действительное причастие прош. вр., мн. ч., род. п.
LAPPD	действительное причастие прош. вр., мн. ч., дат. п.
LAPPA	действительное причастие прош. вр., мн. ч., вин. п., неодуш.
LAPPU	действительное причастие прош. вр., мн. ч., вин. п., одуш.
LAPPI	действительное причастие прош. вр., мн. ч., твор. п.
LAPPR	действительное причастие прош. вр., мн. ч., предл. п.
LAPLMO	действительное причастие прош. вр., возвратное, м. р., им. п.
LAPLMG	действительное причастие прош. вр., возвратное, м. р., род. п.
LAPLMD	действительное причастие прош. вр., возвратное, м. р., дат. п.
LAPLMA	действительное причастие прош. вр., возвратное, м. р., вин. п., неодуш.
LAPLMU	действительное причастие прош. вр., возвратное, м. р., вин. п., одуш.
LAPLMI	действительное причастие прош. вр., возвратное, м. р., твор. п.
LAPLMR	действительное причастие прош. вр., возвратное, м. р., предл. п.
LAPLFO	действительное причастие прош. вр., возвратное, ж. р., им. п.
LAPLFG	действительное причастие прош. вр., возвратное, ж. р., род. п.
LAPLFD	действительное причастие прош. вр., возвратное, ж. р., дат. п.
LAPLFA	действительное причастие прош. вр., возвратное, ж. р., вин. п.
LAPLFI	действительное причастие прош. вр., возвратное, ж. р., твор. п.
LAPLFS	действительное причастие прош. вр., возвратное, ж. р., твор. п., (~ю)
LAPLFR	действительное причастие прош. вр., возвратное, ж. р., предл. п.
LAPLNO	действительное причастие прош. вр., возвратное, ср. р., им. п.
LAPLNG	действительное причастие прош. вр., возвратное, ср. р., род. п.
LAPLND	действительное причастие прош. вр., возвратное, ср. р., дат. п.
LAPLNA	действительное причастие прош. вр., возвратное, ср. р., вин. п.
LAPLNI	действительное причастие прош. вр., возвратное, ср. р., твор. п.
LAPLNR	действительное причастие прош. вр., возвратное, ср. р., предл. п.
LAPLPO	действительное причастие прош. вр., возвратное, мн. ч., им. п.
LAPLPG	действительное причастие прош. вр., возвратное, мн. ч., род. п.
LAPLPD	действительное причастие прош. вр., возвратное, мн. ч., дат. п.
LAPLPA	действительное причастие прош. вр., возвратное, мн. ч., вин. п., неодуш.
LAPLPU	действительное причастие прош. вр., возвратное, мн. ч., вин. п., одуш.
LAPLPI	действительное причастие прош. вр., возвратное, мн. ч., твор. п.
LAPLPR	действительное причастие прош. вр., возвратное, мн. ч., предл. п.
LPRMO	страдательное причастие наст. вр., м. р., им. п.
LPRMG	страдательное причастие наст. вр., м. р., род. п.
LPRMD	страдательное причастие наст. вр., м. р., дат. п.
LPRMA	страдательное причастие наст. вр., м. р., вин. п., неодуш.
LPRMU	страдательное причастие наст. вр., м. р., вин. п., одуш.
LPRMI	страдательное причастие наст. вр., м. р., твор. п.
LPRMR	страдательное причастие наст. вр., м. р., предл. п.
LPRFO	страдательное причастие наст. вр., ж. р., им. п.
LPRFG	страдательное причастие наст. вр., ж. р., род. п.
LPRFD	страдательное причастие наст. вр., ж. р., дат. п.
LPRFA	страдательное причастие наст. вр., ж. р., вин. п.
LPRFI	страдательное причастие наст. вр., ж. р., твор. п.
LPRFS	страдательное причастие наст. вр., ж. р., твор. п., (~ю)
LPRFR	страдательное причастие наст. вр., ж. р., предл. п.
LPRNO	страдательное причастие наст. вр., ср. р., им. п.
LPRNG	страдательное причастие наст. вр., ср. р., род. п.
LPRND	страдательное причастие наст. вр., ср. р., дат. п.
LPRNA	страдательное причастие наст. вр., ср. р., вин. п.
LPRNI	страдательное причастие наст. вр., ср. р., твор. п.
LPRNR	страдательное причастие наст. вр., ср. р., предл. п.
LPRPO	страдательное причастие наст. вр., мн. ч., им. п.
LPRPG	страдательное причастие наст. вр., мн. ч., род. п.
LPRPD	страдательное причастие наст. вр., мн. ч., дат. п.
LPRPA	страдательное причастие наст. вр., мн. ч., вин. п., неодуш.
LPRPU	страдательное причастие наст. вр., мн. ч., вин. п., одуш.
LPRPI	страдательное причастие наст. вр., мн. ч., твор. п.
LPRPR	страдательное причастие наст. вр., мн. ч., предл. п.
LPRHM	краткое страдательное причастие наст. вр., м. р.
LPRHF	краткое страдательное причастие наст. вр., ж. р.
LPRHN	краткое страдательное причастие наст. вр., ср. р.
LPRHP	краткое страдательное причастие наст. вр., мн. ч.
LPPMO	страдательное причастие прош. вр., м. р., им. п.
LPPMG	страдательное причастие прош. вр., м. р., род. п.
LPPMD	страдательное причастие прош. вр., м. р., дат. п.
LPPMA	страдательное причастие прош. вр., м. р., вин. п., неодуш.
LPPMU	страдательное причастие прош. вр., м. р., вин. п., одуш.
LPPMI	страдательное причастие прош. вр., м. р., твор. п.
LPPMR	страдательное причастие прош. вр., м. р., предл. п.
LPPFO	страдательное причастие прош. вр., ж. р., им. п.
LPPFG	страдательное причастие прош. вр., ж. р., род. п.
LPPFD	страдательное причастие прош. вр., ж. р., дат. п.
LPPFA	страдательное причастие прош. вр., ж. р., вин. п.
LPPFI	страдательное причастие прош. вр., ж. р., твор. п.
LPPFS	страдательное причастие прош. вр., ж. р., твор. п., (~ю)
LPPFR	страдательное причастие прош. вр., ж. р., предл. п.
LPPNO	страдательное причастие прош. вр., ср. р., им. п.
LPPNG	страдательное причастие прош. вр., ср. р., род. п.
LPPND	страдательное причастие прош. вр., ср. р., дат. п.
LPPNA	страдательное причастие прош. вр., ср. р., вин. п.
LPPNI	страдательное причастие прош. вр., ср. р., твор. п.
LPPNR	страдательное причастие прош. вр., ср. р., предл. п.
LPPPO	страдательное причастие прош. вр., мн. ч., им. п.
LPPPG	страдательное причастие прош. вр., мн. ч., род. п.
LPPPD	страдательное причастие прош. вр., мн. ч., дат. п.
LPPPA	страдательное причастие прош. вр., мн. ч., вин. п., неодуш.
LPPPU	страдательное причастие прош. вр., мн. ч., вин. п., одуш.
LPPPI	страдательное причастие прош. вр., мн. ч., твор. п.
LPPPR	страдательное причастие прош. вр., мн. ч., предл. п.
LPPHM	краткое страдательное причастие прош. вр., м. р.
LPPHF	краткое страдательное причастие прош. вр., ж. р.
LPPHN	краткое страдательное причастие прош. вр., ср. р.
LPPHP	краткое страдательное причастие прош. вр., мн. ч.
MD	предикатив (слово категории состояния)
NNAMO	имя сущ. (нариц., одушевленное, м. р.), им. п.
NNAMG	имя сущ. (нариц., одушевленное, м. р.), род. п.
NNAMD	имя сущ. (нариц., одушевленное, м. р.), дат. п.
NNAMA	имя сущ. (нариц., одушевленное, м. р.), вин. п.
NNAMI	имя сущ. (нариц., одушевленное, м. р.), твор. п.
NNAMS	имя сущ. (нариц., одушевленное, м. р.), твор. п., (~ю)
NNAMR	имя сущ. (нариц., одушевленное, м. р.), предл. п.
NNAMPO	имя сущ. (нариц., одушевленное, м. р.), мн. ч., им. п.
NNAMPG	имя сущ. (нариц., одушевленное, м. р.), мн. ч., род. п.
NNAMPD	имя сущ. (нариц., одушевленное, м. р.), мн. ч., дат. п.
NNAMPA	имя сущ. (нариц., одушевленное, м. р.), мн. ч., вин. п.
NNAMPI	имя сущ. (нариц., одушевленное, м. р.), мн. ч., твор. п.
NNAMPR	имя сущ. (нариц., одушевленное, м. р.), мн. ч., предл. п.
NNIMO	имя сущ. (нариц., неодушевленное, м. р.), им. п.
NNIMG	имя сущ. (нариц., неодушевленное, м. р.), род. п.
NNIME	имя сущ. (нариц., неодушевленное, м. р.), род. п. (партитивный)
NNIMD	имя сущ. (нариц., неодушевленное, м. р.), дат. п.
NNIMA	имя сущ. (нариц., неодушевленное, м. р.), вин. п.
NNIMI	имя сущ. (нариц., неодушевленное, м. р.), твор. п.
NNIMS	имя сущ. (нариц., неодушевленное, м. р.), твор. п., (~ю)
NNIMR	имя сущ. (нариц., неодушевленное, м. р.), предл. п.
NNIMPO	имя сущ. (нариц., неодушевленное, м. р.), мн. ч., им. п.
NNIMPG	имя сущ. (нариц., неодушевленное, м. р.), мн. ч., род. п.
NNIMPD	имя сущ. (нариц., неодушевленное, м. р.), мн. ч., дат. п.
NNIMPA	имя сущ. (нариц., неодушевленное, м. р.), мн. ч., вин. п.
NNIMPI	имя сущ. (нариц., неодушевленное, м. р.), мн. ч., твор. п.
NNIMPR	имя сущ. (нариц., неодушевленное, м. р.), мн. ч., предл. п.
NNAFO	имя сущ. (нариц., одушевленное, ж. р.), им. п.
NNAFG	имя сущ. (нариц., одушевленное, ж. р.), род. п.
NNAFD	имя сущ. (нариц., одушевленное, ж. р.), дат. п.
NNAFA	имя сущ. (нариц., одушевленное, ж. р.), вин. п.
NNAFI	имя сущ. (нариц., одушевленное, ж. р.), твор. п.
NNAFS	имя сущ. (нариц., одушевленное, ж. р.), твор. п., (~ю)
NNAFR	имя сущ. (нариц., одушевленное, ж. р.), предл. п.
NNAFPO	имя сущ. (нариц., одушевленное, ж. р.), мн. ч., им. п.
NNAFPG	имя сущ. (нариц., одушевленное, ж. р.), мн. ч., род. п.
NNAFPD	имя сущ. (нариц., одушевленное, ж. р.), мн. ч., дат. п.
NNAFPA	имя сущ. (нариц., одушевленное, ж. р.), мн. ч., вин. п.
NNAFPI	имя сущ. (нариц., одушевленное, ж. р.), мн. ч., твор. п.
NNAFPR	имя сущ. (нариц., одушевленное, ж. р.), мн. ч., предл. п.
NNIFO	имя сущ. (нариц., неодушевленное, ж. р.), им. п.
NNIFG	имя сущ. (нариц., неодушевленное, ж. р.), род. п.
NNIFD	имя сущ. (нариц., неодушевленное, ж. р.), дат. п.
NNIFA	имя сущ. (нариц., неодушевленное, ж. р.), вин. п.
NNIFI	имя сущ. (нариц., неодушевленное, ж. р.), твор. п.
NNIFS	имя сущ. (нариц., неодушевленное, ж. р.), твор. п.,  (~ю)
NNIFR	имя сущ. (нариц., неодушевленное, ж. р.), предл. п.
NNIFPO	имя сущ. (нариц., неодушевленное, ж. р.), мн. ч., им. п.
NNIFPG	имя сущ. (нариц., неодушевленное, ж. р.), мн. ч., род. п.
NNIFPD	имя сущ. (нариц., неодушевленное, ж. р.), мн. ч., дат. п.
NNIFPA	имя сущ. (нариц., неодушевленное, ж. р.), мн. ч., вин. п.
NNIFPI	имя сущ. (нариц., неодушевленное, ж. р.), мн. ч., твор. п.
NNIFPR	имя сущ. (нариц., неодушевленное, ж. р.), мн. ч., предл. п.
NNANO	имя сущ. (нариц., одушевленное, ср. р.), им. п.
NNANG	имя сущ. (нариц., одушевленное, ср. р.), род. п.
NNAND	имя сущ. (нариц., одушевленное, ср. р.), дат. п.
NNANA	имя сущ. (нариц., одушевленное, ср. р.), вин. п.
NNANI	имя сущ. (нариц., одушевленное, ср. р.), твор. п.
NNANR	имя сущ. (нариц., одушевленное, ср. р.), предл. п.
NNANPO	имя сущ. (нариц., одушевленное, ср. р.), мн. ч., им. п.
NNANPG	имя сущ. (нариц., одушевленное, ср. р.), мн. ч., род. п.
NNANPD	имя сущ. (нариц., одушевленное, ср. р.), мн. ч., дат. п.
NNANPA	имя сущ. (нариц., одушевленное, ср. р.), мн. ч., вин. п.
NNANPI	имя сущ. (нариц., одушевленное, ср. р.), мн. ч., твор. п.
NNANPR	имя сущ. (нариц., одушевленное, ср. р.), мн. ч., предл. п.
NNINO	имя сущ. (нариц., неодушевленное, ср. р.), им. п.
NNING	имя сущ. (нариц., неодушевленное, ср. р.), род. п.
NNIND	имя сущ. (нариц., неодушевленное, ср. р.), дат. п.
NNINA	имя сущ. (нариц., неодушевленное, ср. р.), вин. п.
NNINI	имя сущ. (нариц., неодушевленное, ср. р.), твор. п.
NNINR	имя сущ. (нариц., неодушевленное, ср. р.), предл. п.
NNINPO	имя сущ. (нариц., неодушевленное, ср. р.), мн. ч., им. п.
NNINPG	имя сущ. (нариц., неодушевленное, ср. р.), мн. ч., род. п.
NNINPD	имя сущ. (нариц., неодушевленное, ср. р.), мн. ч., дат. п.
NNINPA	имя сущ. (нариц., неодушевленное, ср. р.), мн. ч., вин. п.
NNINPI	имя сущ. (нариц., неодушевленное, ср. р.), мн. ч., твор. п.
NNINPR	имя сущ. (нариц., неодушевленное, ср. р.), мн. ч., предл. п.
NNAPO	имя сущ. (нариц., одушевленное, мн. ч. только), им. п.
NNAPG	имя сущ. (нариц., одушевленное, мн. ч. только), род. п.
NNAPD	имя сущ. (нариц., одушевленное, мн. ч. только), дат. п.
NNAPA	имя сущ. (нариц., одушевленное, мн. ч. только), вин. п.
NNAPI	имя сущ. (нариц., одушевленное, мн. ч. только), твор. п.
NNAPR	имя сущ. (нариц., одушевленное, мн. ч. только), предл. п.
NNIPO	имя сущ. (нариц., неодушевленное, мн. ч. только), им. п.
NNIPG	имя сущ. (нариц., неодушевленное, мн. ч. только), род. п.
NNIPD	имя сущ. (нариц., неодушевленное, мн. ч. только), дат. п.
NNIPA	имя сущ. (нариц., неодушевленное, мн. ч. только), вин. п.						
NNIPI	имя сущ. (нариц., неодушевленное, мн. ч. только), твор. п.
NNIPR	имя сущ. (нариц., неодушевленное, мн. ч. только), предл. п.
NJAMO	имя сущ. (субст. прил., одушевленное, м. р.), им. п.
NJAMG	имя сущ. (субст. прил., одушевленное, м. р.), род. п.
NJAMD	имя сущ. (субст. прил., одушевленное, м. р.), дат. п.
NJAMA	имя сущ. (субст. прил., одушевленное, м. р.), вин. п.
NJAMI	имя сущ. (субст. прил., одушевленное, м. р.), твор. п.
NJAMR	имя сущ. (субст. прил., одушевленное, м. р.), предл. п.
NJAMPO	имя сущ. (субст. прил., одушевленное, м. р.), мн. ч., им. п.
NJAMPG	имя сущ. (субст. прил., одушевленное, м. р.), мн. ч., род. п.
NJAMPD	имя сущ. (субст. прил., одушевленное, м. р.), мн. ч., дат. п.
NJAMPA	имя сущ. (субст. прил., одушевленное, м. р.), мн. ч., вин. п.
NJAMPI	имя сущ. (субст. прил., одушевленное, м. р.), мн. ч., твор. п.
NJAMPR	имя сущ. (субст. прил., одушевленное, м. р.), мн. ч., предл. п.
NJIMO	имя сущ. (субст. прил., неодушевленное, м. р.), им. п.
NJIMG	имя сущ. (субст. прил., неодушевленное, м. р.), род. п.
NJIMD	имя сущ. (субст. прил., неодушевленное, м. р.), дат. п.
NJIMA	имя сущ. (субст. прил., неодушевленное, м. р.), вин. п.
NJIMI	имя сущ. (субст. прил., неодушевленное, м. р.), твор. п.
NJIMR	имя сущ. (субст. прил., неодушевленное, м. р.), предл. п.
NJIMPO	имя сущ. (субст. прил., неодушевленное, м. р.), мн. ч., им. п.
NJIMPG	имя сущ. (субст. прил., неодушевленное, м. р.), мн. ч., род. п.
NJIMPD	имя сущ. (субст. прил., неодушевленное, м. р.), мн. ч., дат. п.
NJIMPA	имя сущ. (субст. прил., неодушевленное, м. р.), мн. ч., вин. п.
NJIMPI	имя сущ. (субст. прил., неодушевленное, м. р.), мн. ч., твор. п.
NJIMPR	имя сущ. (субст. прил., неодушевленное, м. р.), мн. ч., предл. п.
NJAFO	имя сущ. (субст. прил., одушевленное, ж. р.), им. п.
NJAFG	имя сущ. (субст. прил., одушевленное, ж. р.), род. п.
NJAFD	имя сущ. (субст. прил., одушевленное, ж. р.), дат. п.
NJAFA	имя сущ. (субст. прил., одушевленное, ж. р.), вин. п.
NJAFI	имя сущ. (субст. прил., одушевленное, ж. р.), твор. п.
NJAFS	имя сущ. (субст. прил., одушевленное, ж. р.), твор. п., (~ю)
NJAFR	имя сущ. (субст. прил., одушевленное, ж. р.), предл. п.
NJAFPO	имя сущ. (субст. прил., одушевленное, ж. р.), мн. ч., им. п.
NJAFPG	имя сущ. (субст. прил., одушевленное, ж. р.), мн. ч., род. п.
NJAFPD	имя сущ. (субст. прил., одушевленное, ж. р.), мн. ч., дат. п.
NJAFPA	имя сущ. (субст. прил., одушевленное, ж. р.), мн. ч., вин. п.
NJAFPI	имя сущ. (субст. прил., одушевленное, ж. р.), мн. ч., твор. п.
NJAFPR	имя сущ. (субст. прил., одушевленное, ж. р.), мн. ч., предл. п.
NJIFO	имя сущ. (субст. прил., неодушевленное, ж. р.), им. п.
NJIFG	имя сущ. (субст. прил., неодушевленное, ж. р.), род. п.
NJIFD	имя сущ. (субст. прил., неодушевленное, ж. р.), дат. п.
NJIFA	имя сущ. (субст. прил., неодушевленное, ж. р.), вин. п.
NJIFI	имя сущ. (субст. прил., неодушевленное, ж. р.), твор. п.
NJIFS	имя сущ. (субст. прил., неодушевленное, ж. р.), твор. п., (~ю)
NJIFR	имя сущ. (субст. прил., неодушевленное, ж. р.), предл. п.
NJIFPO	имя сущ. (субст. прил., неодушевленное, ж. р.), мн. ч., им. п.
NJIFPG	имя сущ. (субст. прил., неодушевленное, ж. р.), мн. ч., род. п.
NJIFPD	имя сущ. (субст. прил., неодушевленное, ж. р.), мн. ч., дат. п.
NJIFPA	имя сущ. (субст. прил., неодушевленное, ж. р.), мн. ч., вин. п.
NJIFPI	имя сущ. (субст. прил., неодушевленное, ж. р.), мн. ч., твор. п.
NJIFPR	имя сущ. (субст. прил., неодушевленное, ж. р.), мн. ч., предл. п.
NJANO	имя сущ. (субст. прил., одушевленное, ср. р.), им. п.
NJANG	имя сущ. (субст. прил., одушевленное, ср. р.), род. п.
NJAND	имя сущ. (субст. прил., одушевленное, ср. р.), дат. п.
NJANA	имя сущ. (субст. прил., одушевленное, ср. р.), вин. п.
NJANI	имя сущ. (субст. прил., одушевленное, ср. р.), твор. п.
NJANR	имя сущ. (субст. прил., одушевленное, ср. р.), предл. п.
NJANPO	имя сущ. (субст. прил., одушевленное, ср. р.), мн. ч., им. п.
NJANPG	имя сущ. (субст. прил., одушевленное, ср. р.), мн. ч., род. п.
NJANPD	имя сущ. (субст. прил., одушевленное, ср. р.), мн. ч., дат. п.
NJANPA	имя сущ. (субст. прил., одушевленное, ср. р.), мн. ч., вин. п.
NJANPI	имя сущ. (субст. прил., одушевленное, ср. р.), мн. ч., твор. п.
NJANPR	имя сущ. (субст. прил., одушевленное, ср. р.), мн. ч., предл. п.
NJINO	имя сущ. (субст. прил., неодушевленное, ср. р.), им. п.
NJING	имя сущ. (субст. прил., неодушевленное, ср. р.), род. п.
NJIND	имя сущ. (субст. прил., неодушевленное, ср. р.), дат. п.
NJINA	имя сущ. (субст. прил., неодушевленное, ср. р.), вин. п.
NJINI	имя сущ. (субст. прил., неодушевленное, ср. р.), твор. п.
NJINR	имя сущ. (субст. прил., неодушевленное, ср. р.), предл. п.
NJINPO	имя сущ. (субст. прил., неодушевленное, ср. р.), мн. ч., им. п.
NJINPG	имя сущ. (субст. прил., неодушевленное, ср. р.), мн. ч., род. п.
NJINPD	имя сущ. (субст. прил., неодушевленное, ср. р.), мн. ч., дат. п.
NJINPA	имя сущ. (субст. прил., неодушевленное, ср. р.), мн. ч., вин. п.
NJINPI	имя сущ. (субст. прил., неодушевленное, ср. р.), мн. ч., твор. п.
NJINPR	имя сущ. (субст. прил., неодушевленное, ср. р.), мн. ч., предл. п.
NJAPO	имя сущ. (субст. прил., одушевленное, мн. ч. только), им. п.
NJAPG	имя сущ. (субст. прил., одушевленное, мн. ч. только), род. п.
NJAPD	имя сущ. (субст. прил., одушевленное, мн. ч. только), дат. п.
NJAPA	имя сущ. (субст. прил., одушевленное, мн. ч. только), вин. п.
NJAPI	имя сущ. (субст. прил., одушевленное, мн. ч. только), твор. п.
NJAPR	имя сущ. (субст. прил., одушевленное, мн. ч. только), предл. п.
NJIPO	имя сущ. (субст. прил., неодушевленное, мн. ч. только), им. п.
NJIPG	имя сущ. (субст. прил., неодушевленное, мн. ч. только), род. п.
NJIPD	имя сущ. (субст. прил., неодушевленное, мн. ч. только), дат. п.
NJIPA	имя сущ. (субст. прил., неодушевленное, мн. ч. только), вин. п.
NJIPI	имя сущ. (субст. прил., неодушевленное, мн. ч. только), твор. п.
NJIPR	имя сущ. (субст. прил., неодушевленное, мн. ч. только), предл. п.
NPAMO	имя сущ. (собственное, одушевленное, м. р.), им. п.
NPAMG	имя сущ. (собственное, одушевленное, м. р.), род. п.
NPAMD	имя сущ. (собственное, одушевленное, м. р.), дат. п.
NPAMA	имя сущ. (собственное, одушевленное, м. р.), вин. п.
NPAMI	имя сущ. (собственное, одушевленное, м. р.), твор. п.
NPAMR	имя сущ. (собственное, одушевленное, м. р.), предл. п.
NPAMPO	имя сущ. (собственное, одушевленное, м. р.), мн.ч., им. п.
NPAMPG	имя сущ. (собственное, одушевленное, м. р.), мн.ч., род. п.
NPAMPD	имя сущ. (собственное, одушевленное, м. р.), мн.ч., дат. п.
NPAMPA	имя сущ. (собственное, одушевленное, м. р.), мн.ч., вин. п.
NPAMPI	имя сущ. (собственное, одушевленное, м. р.), мн.ч., твор. п.
NPAMPR	имя сущ. (собственное, одушевленное, м. р.), мн.ч., предл. п.
NPIMO	имя сущ. (собственное, неодушевленное, м. р.), им. п.
NPIMG	имя сущ. (собственное, неодушевленное, м. р.), род. п.
NPIMD	имя сущ. (собственное, неодушевленное, м. р.), дат. п.
NPIMA	имя сущ. (собственное, неодушевленное, м. р.), вин. п.
NPIMI	имя сущ. (собственное, неодушевленное, м. р.), твор. п.
NPIMR	имя сущ. (собственное, неодушевленное, м. р.), предл. п.
NPIMPO	имя сущ. (собственное, неодушевленное, м. р.), мн.ч., им. п.
NPIMPG	имя сущ. (собственное, неодушевленное, м. р.), мн.ч., род. п.
NPIMPD	имя сущ. (собственное, неодушевленное, м. р.), мн.ч., дат. п.
NPIMPA	имя сущ. (собственное, неодушевленное, м. р.), мн.ч., вин. п.
NPIMPI	имя сущ. (собственное, неодушевленное, м. р.), мн.ч., твор. п.
NPIMPR	имя сущ. (собственное, неодушевленное, м. р.), мн.ч., предл. п.
NPAFO	имя сущ. (собственное, одушевленное, ж. р.), им. п.
NPAFG	имя сущ. (собственное, одушевленное, ж. р.), род. п.
NPAFD	имя сущ. (собственное, одушевленное, ж. р.), дат. п.
NPAFA	имя сущ. (собственное, одушевленное, ж. р.), вин. п.
NPAFI	имя сущ. (собственное, одушевленное, ж. р.), твор. п.
NPAFS	имя сущ. (собственное, одушевленное, ж. р.), твор. п., (~ю)
NPAFR	имя сущ. (собственное, одушевленное, ж. р.), предл. п.
NPAFPO	имя сущ. (собственное, одушевленное, ж. р.), мн.ч., им. п.
NPAFPG	имя сущ. (собственное, одушевленное, ж. р.), мн.ч., род. п.
NPAFPD	имя сущ. (собственное, одушевленное, ж. р.), мн.ч., дат. п.
NPAFPA	имя сущ. (собственное, одушевленное, ж. р.), мн.ч., вин. п.
NPAFPI	имя сущ. (собственное, одушевленное, ж. р.), мн.ч., твор. п.
NPAFPR	имя сущ. (собственное, одушевленное, ж. р.), мн.ч., предл. п.
NPIFO	имя сущ. (собственное, неодушевленное, ж. р.), им. п.
NPIFG	имя сущ. (собственное, неодушевленное, ж. р.), род. п.
NPIFD	имя сущ. (собственное, неодушевленное, ж. р.), дат. п.
NPIFA	имя сущ. (собственное, неодушевленное, ж. р.), вин. п.
NPIFI	имя сущ. (собственное, неодушевленное, ж. р.), твор. п.
NPIFS	имя сущ. (собственное, неодушевленное, ж. р.), твор. п., (~ю)
NPIFR	имя сущ. (собственное, неодушевленное, ж. р.), предл. п.
NPIFPO	имя сущ. (собственное, неодушевленное, ж. р.), мн.ч., им. п.
NPIFPG	имя сущ. (собственное, неодушевленное, ж. р.), мн.ч., род. п.
NPIFPD	имя сущ. (собственное, неодушевленное, ж. р.), мн.ч., дат. п.
NPIFPA	имя сущ. (собственное, неодушевленное, ж. р.), мн.ч., вин. п.
NPIFPI	имя сущ. (собственное, неодушевленное, ж. р.), мн.ч., твор. п.
NPIFPR	имя сущ. (собственное, неодушевленное, ж. р.), мн.ч., предл. п.
NPINO	имя сущ. (собственное, неодушевленное, ср. р.), им. п.
NPING	имя сущ. (собственное, неодушевленное, ср. р.), род. п.
NPIND	имя сущ. (собственное, неодушевленное, ср. р.), дат. п.
NPINA	имя сущ. (собственное, неодушевленное, ср. р.), вин. п.
NPINI	имя сущ. (собственное, неодушевленное, ср. р.), твор. п.
NPINR	имя сущ. (собственное, неодушевленное, ср. р.), предл. п.
NPINPO	имя сущ. (собственное, неодушевленное, ср. р.), мн.ч., им. п.
NPINPG	имя сущ. (собственное, неодушевленное, ср. р.), мн.ч., род. п.
NPINPD	имя сущ. (собственное, неодушевленное, ср. р.), мн.ч., дат. п.
NPINPA	имя сущ. (собственное, неодушевленное, ср. р.), мн.ч., вин. п.
NPINPI	имя сущ. (собственное, неодушевленное, ср. р.), мн.ч., твор. п.
NPINPR	имя сущ. (собственное, неодушевленное, ср. р.), мн.ч., предл. п.
NPIPO	имя сущ. (собственное, неодушевленное, мн. ч. только), им. п.
NPIPG	имя сущ. (собственное, неодушевленное, мн. ч. только), род. п.
NPIPD	имя сущ. (собственное, неодушевленное, мн. ч. только), дат. п.
NPIPA	имя сущ. (собственное, неодушевленное, мн. ч. только), вин. п.
NPIPI	имя сущ. (собственное, неодушевленное, мн. ч. только), твор. п.
NPIPR	имя сущ. (собственное, неодушевленное, мн. ч. только), предл. п.
PSMO	притяжательное мест., м. р., им. п.
PSMG	притяжательное мест., м. р., род. п.
PSMD	притяжательное мест., м. р., дат. п.
PSMA	притяжательное мест., м. р., вин. п., неодуш.
PSMU	притяжательное мест., м. р., вин. п., одуш.
PSMI	притяжательное мест., м. р., твор. п.
PSMR	притяжательное мест., м. р., предл. п.
PSFO	притяжательное мест., ж. р., им. п.
PSFG	притяжательное мест., ж. р., род. п.
PSFD	притяжательное мест., ж. р., дат. п.
PSFA	притяжательное мест., ж. р., вин. п.
PSFI	притяжательное мест., ж. р., твор. п.
PSFS	притяжательное мест., ж. р., твор. п., (~ю)
PSFR	притяжательное мест., ж. р., предл. п.
PSNO	притяжательное мест., ср. р., им. п.
PSNG	притяжательное мест., ср. р., род. п.
PSND	притяжательное мест., ср. р., дат. п.
PSNA	притяжательное мест., ср. р., вин. п.
PSNI	притяжательное мест., ср. р., твор. п.
PSNR	притяжательное мест., ср. р., предл. п.
PSPO	притяжательное мест., мн. ч., им. п.
PSPG	притяжательное мест., мн. ч., род. п.
PSPD	притяжательное мест., мн. ч., дат. п.
PSPA	притяжательное мест., мн. ч., вин. п., неодуш.
PSPU	притяжательное мест., мн. ч., вин. п., одуш.
PSPI	притяжательное мест., мн. ч., твор. п.
PSPR	притяжательное мест., мн. ч., предл. п.
PP1O	личное мест. я 1-го лица ед. ч., им. п.
PP1G	личное мест. я 1-го лица ед. ч., род. п.
PP1D	личное мест. я 1-го лица ед. ч., дат. п.
PP1A	личное мест. я 1-го лица ед. ч., вин. п.
PP1I	личное мест. я 1-го лица ед. ч., твор. п.
PP1R	личное мест. я 1-го лица ед. ч., предл. п.
PP1PO	личное мест. мы 1-го лица мн. ч., им. п.
PP1PG	личное мест. мы 1-го лица мн. ч., род. п.
PP1PD	личное мест. мы 1-го лица мн. ч., дат. п.
PP1PA	личное мест. мы 1-го лица мн. ч., вин. п.
PP1PI	личное мест. мы 1-го лица мн. ч., твор. п.
PP1PR	личное мест. мы 1-го лица мн. ч., предл. п.
PP2O	личное мест. ты 2-го лица ед. ч., им. п.
PP2G	личное мест. ты 2-го лица ед. ч., род. п.
PP2D	личное мест. ты 2-го лица ед. ч., дат. п.
PP2A	личное мест. ты 2-го лица ед. ч., вин. п.
PP2I	личное мест. ты 2-го лица ед. ч., твор. п.
PP2R	личное мест. ты 2-го лица ед. ч., предл. п.
PP2PO	личное мест. вы 2-го лица мн. ч., им. п.
PP2PG	личное мест. вы 2-го лица мн. ч., род. п.
PP2PD	личное мест. вы 2-го лица мн. ч., дат. п.
PP2PA	личное мест. вы 2-го лица мн. ч., вин. п.
PP2PI	личное мест. вы 2-го лица мн. ч., твор. п.
PP2PR	личное мест. вы 2-го лица мн. ч., предл. п.
PP3MO	личное мест. он 3-го лица м. р., им. п.
PP3MG	личное мест. он 3-го лица м. р., род. п.
PP3MD	личное мест. он 3-го лица м. р., дат. п.
PP3MA	личное мест. он 3-го лица м. р., вин. п.
PP3MI	личное мест. он 3-го лица м. р., твор. п.
PP3MR	личное мест. он 3-го лица м. р., предл. п.
PP3FO	личное мест. она 3-го лица ж. р., им. п.
PP3FG	личное мест. она 3-го лица  ж. р., род. п.
PP3FD	личное мест. она 3-го лица  ж. р., дат. п.
PP3FA	личное мест. она 3-го лица  ж. р., вин. п.
PP3FI	личное мест. она 3-го лица  ж. р., твор. п.
PP3FS	личное мест. она 3-го лица  ж. р., твор. п., (~ю)
PP3FR	личное мест. она 3-го лица ж. р., предл. п.
PP3NO	личное мест. оно 3-го лица ср. р., им. п.
PP3NG	личное мест. оно 3-го лица ср. р., род. п.
PP3ND	личное мест. оно 3-го лица ср. р., дат. п.
PP3NA	личное мест. оно 3-го лицаср. р., вин. п.
PP3NI	личное мест. оно 3-го лица ср. р., твор. п.
PP3NR	личное мест. оно 3-го лица ср. р., предл. п.
PP3PO	личное мест. они 3-го лица мн. ч., им. п.
PP3PG	личное мест. они 3-го лица мн. ч., род. п.
PP3PD	личное мест. они 3-го лица мн. ч., дат. п.
PP3PA	личное мест. они 3-го лица мн. ч., вин. п.
PP3PI	личное мест. они 3-го лица  мн. ч., твор. п.
PP3PR	личное мест. они 3-го лица мн. ч., предл. п.
PLG	возвратное мест. себя (без им. п.), род. п.
PLD	возвратное мест. себя (без им. п.), дат. п.
PLA	возвратное мест. себя (без им. п.), вин. п.
PLI	возвратное мест. себя (без им. п.), твор. п.
PLR	возвратное мест. себя (без им. п.), предл. п.
PDMO	указательное мест., м. р., им. п.
PDMG	указательное мест., м. р., род. п.
PDMD	указательное мест., м. р., дат. п.
PDMA	указательное мест., м. р., вин. п., неодуш.
PDMU	указательное мест., м. р., вин. п., одуш.
PDMI	указательное мест., м. р., твор. п.
PDMR	указательное мест., м. р., предл. п.
PDFO	указательное мест., ж. р., им. п.
PDFG	указательное мест., ж. р., род. п.
PDFD	указательное мест., ж. р., дат. п.
PDFA	указательное мест., ж. р., вин. п.
PDFI	указательное мест., ж. р., твор. п.
PDFS	указательное мест., ж. р., твор. п., (~ю)
PDFR	указательное мест., ж. р., предл. п.
PDNO	указательное мест., ср. р., им. п.
PDNG	указательное мест., ср. р., род. п.
PDND	указательное мест., ср. р., дат. п.
PDNA	указательное мест., ср. р., вин. п.
PDNI	указательное мест., ср. р., твор. п.
PDNR	указательное мест., ср. р., предл. п.
PDPO	указательное мест., мн. ч., им. п.
PDPG	указательное мест., мн. ч., род. п.
PDPD	указательное мест., мн. ч., дат. п.
PDPA	указательное мест., мн. ч., вин. п., неодуш.
PDPU	указательное мест., мн. ч., вин. п., одуш.
PDPI	указательное мест., мн. ч., твор. п.
PDPR	указательное мест., мн. ч., предл. п.
PDSO	указательное мест. столько, им. п.
PDSG	указательное мест. столько, род. п.
PDSD	указательное мест. столько, дат. п.
PDSA	указательное мест. столько, вин. п., неодуш.
PDSU	указательное мест. столько, вин. п., одуш.
PDSI	указательное мест. столько, твор. п.
PDSR	указательное мест. столько, предл. п.
PQMO	вопросительно-относительное мест., м. р., им. п.
PQMG	вопросительно-относительное мест., м. р., род. п.
PQMD	вопросительно-относительное мест., м. р., дат. п.
PQMA	вопросительно-относительное мест., м. р., вин. п., неодуш.
PQMU	вопросительно-относительное мест., м. р., вин. п., одуш.
PQMI	вопросительно-относительное мест., м. р., твор. п.
PQMR	вопросительно-относительное мест., м. р., предл. п.
PQFO	вопросительно-относительное мест., ж. р., им. п.
PQFG	вопросительно-относительное мест., ж. р., род. п.
PQFD	вопросительно-относительное мест., ж. р., дат. п.
PQFA	вопросительно-относительное мест., ж. р., вин. п.
PQFI	вопросительно-относительное мест., ж. р., твор. п.
PQFS	вопросительно-относительное мест., ж. р., твор. п., (~ю)
PQFR	вопросительно-относительное мест., ж. р., предл. п.
PQNO	вопросительно-относительное мест., ср. р., им. п.
PQNG	вопросительно-относительное мест., ср. р., род. п.
PQND	вопросительно-относительное мест., ср. р., дат. п.
PQNA	вопросительно-относительное мест., ср. р., вин. п.
PQNI	вопросительно-относительное мест., ср. р., твор. п.
PQNR	вопросительно-относительное мест., ср. р., предл. п.
PQPO	вопросительно-относительное мест., мн. ч., им. п.
PQPG	вопросительно-относительное мест., мн. ч., род. п.
PQPD	вопросительно-относительное мест., мн. ч., дат. п.
PQPA	вопросительно-относительное мест., мн. ч., вин. п., неодуш.
PQPU	вопросительно-относительное мест., мн. ч., вин. п., одуш.
PQPI	вопросительно-относительное мест., мн. ч., твор. п.
PQPR	вопросительно-относительное мест., мн. ч., предл. п.
PQHM	вопросительно-относительное мест. каков, м. р.
PQHF	вопросительно-относительное мест. каков, ж. р.
PQHN	вопросительно-относительное мест. каков, ср. р.
PQHP	вопросительно-относительное мест. каков, мн. ч.
PQSO	вопросительно-относительное мест. сколько, им. п.
PQSG	вопросительно-относительное мест. сколько, род. п.
PQSD	вопросительно-относительное мест. сколько, дат. п.
PQSA	вопросительно-относительное мест. сколько, вин. п., неодуш.
PQSU	вопросительно-относительное мест. сколько, вин. п., одуш.
PQSI	вопросительно-относительное мест. сколько, твор. п.
PQSR	вопросительно-относительное мест. сколько, предл. п.
PQAMO	вопросительно-относительное мест. кто, м. р. только, им. п.
PQAMG	вопросительно-относительное мест. кто, м. р. только, род. п.
PQAMD	вопросительно-относительное мест. кто, м. р. только, дат. п.
PQAMA	вопросительно-относительное мест. кто, м. р. только, вин. п.
PQAMI	вопросительно-относительное мест. кто, м. р. только, твор. п.
PQAMR	вопросительно-относительное мест. кто, м. р. только, предл. п.
PQINO	вопросительно-относительное мест. что, ср. р. только, им. п.
PQING	вопросительно-относительное мест. что, ср. р. только, род. п.
PQIND	вопросительно-относительное мест. что, ср. р. только, дат. п.
PQINA	вопросительно-относительное мест. что, ср. р. только, вин. п.
PQINI	вопросительно-относительное мест. что, ср. р. только, твор. п.
PQINR	вопросительно-относительное мест. что, ср. р. только, предл. п.
PTMO	определительное мест., м. р., им. п.
PTMG	определительное мест., м. р., род. п.
PTMD	определительное мест., м. р., дат. п.
PTMA	определительное мест., м. р., вин. п., неодуш.
PTMU	определительное мест., м. р., вин. п., одуш.
PTMI	определительное мест., м. р., твор. п.
PTMR	определительное мест., м. р., предл. п.
PTFO	определительное мест., ж. р., им. п.
PTFG	определительное мест., ж. р., род. п.
PTFD	определительное мест., ж. р., дат. п.
PTFA	определительное мест., ж. р., вин. п.
PTFI	определительное мест., ж. р., твор. п.
PTFS	определительное мест., ж. р., твор. п., (~ю)
PTFR	определительное мест., ж. р., предл. п.
PTNO	определительное мест., ср. р., им. п.
PTNG	определительное мест., ср. р., род. п.
PTND	определительное мест., ср. р., дат. п.
PTNA	определительное мест., ср. р., вин. п.
PTNI	определительное мест., ср. р., твор. п.
PTNR	определительное мест., ср. р., предл. п.
PTPO	определительное мест., мн. ч., им. п.
PTPG	определительное мест., мн. ч., род. п.
PTPD	определительное мест., мн. ч., дат. п.
PTPA	определительное мест., мн. ч., вин. п., неодуш.
PTPU	определительное мест., мн. ч., вин. п., одуш.
PTPI	определительное мест., мн. ч., твор. п.
PTPR	определительное мест., мн. ч., предл. п.
PNMO	отрицательное мест., м. р., им. п.
PNMG	отрицательное мест., м. р., род. п.
PNMD	отрицательное мест., м. р., дат. п.
PNMA	отрицательное мест., м. р., вин. п., неодуш.
PNMU	отрицательное мест., м. р., вин. п., одуш.
PNMI	отрицательное мест., м. р., твор. п.
PNMR	отрицательное мест., м. р., предл. п.
PNFO	отрицательное мест., ж. р., им. п.
PNFG	отрицательное мест., ж. р., род. п.
PNFD	отрицательное мест., ж. р., дат. п.
PNFA	отрицательное мест., ж. р., вин. п.
PNFI	отрицательное мест., ж. р., твор. п.
PNFS	отрицательное мест., ж. р., твор. п., (~ю)
PNFR	отрицательное мест., ж. р., предл. п.
PNNO	отрицательное мест., ср. р., им. п.
PNNG	отрицательное мест., ср. р., род. п.
PNND	отрицательное мест., ср. р., дат. п.
PNNA	отрицательное мест., ср. р., вин. п.
PNNI	отрицательное мест., ср. р., твор. п.
PNNR	отрицательное мест., ср. р., предл. п.
PNPO	отрицательное мест., мн. ч., им. п.
PNPG	отрицательное мест., мн. ч., род. п.
PNPD	отрицательное мест., мн. ч., дат. п.
PNPA	отрицательное мест., мн. ч., вин. п., неодуш.
PNPU	отрицательное мест., мн. ч., вин. п., одуш.
PNPI	отрицательное мест., мн. ч., твор. п.
PNPR	отрицательное мест., мн. ч., предл. п.
PNAMO	отрицательное мест. никто, некого, м. р. только, им. п.
PNAMG	отрицательное мест. никто, некого, м. р. только, род. п.
PNAMD	отрицательное мест. никто, некого, м. р. только, дат. п.
PNAMA	отрицательное мест. никто, некого, м. р. только, вин. п.
PNAMI	отрицательное мест. никто, некого, м. р. только, твор. п.
PNAMR	отрицательное мест. никто, некого, м. р. только, предл. п.
PNINO	отрицательное мест. ничто, нечего, ср. р. только, им. п.
PNING	отрицательное мест. ничто, нечего, ср. р. только, род. п.
PNIND	отрицательное мест. ничто, нечего, ср. р. только, дат. п.
PNINA	отрицательное мест. ничто, нечего, ср. р. только, вин. п.
PNINI	отрицательное мест. ничто, нечего, ср. р. только, твор. п.
PNINR	отрицательное мест. ничто, нечего, ср. р. только, предл. п.
PRMO	неопределенное мест., м. р., им. п.
PRMG	неопределенное мест., м. р., род. п.
PRMD	неопределенное мест., м. р., дат. п.
PRMA	неопределенное мест., м. р., вин. п., неодуш.
PRMU	неопределенное мест., м. р., вин. п., одуш.
PRMI	неопределенное мест., м. р., твор. п.
PRMR	неопределенное мест., м. р., предл. п.
PRFO	неопределенное мест., ж. р., им. п.
PRFG	неопределенное мест., ж. р., род. п.
PRFD	неопределенное мест., ж. р., дат. п.
PRFA	неопределенное мест., ж. р., вин. п.
PRFI	неопределенное мест., ж. р., твор. п.
PRFS	неопределенное мест., ж. р., твор. п., (~ю)
PRFR	неопределенное мест., ж. р., предл. п.
PRNO	неопределенное мест., ср. р., им. п.
PRNG	неопределенное мест., ср. р., род. п.
PRND	неопределенное мест., ср. р., дат. п.
PRNA	неопределенное мест., ср. р., вин. п.
PRNI	неопределенное мест., ср. р., твор. п.
PRNR	неопределенное мест., ср. р., предл. п.
PRPO	неопределенное мест., мн. ч., им. п.
PRPG	неопределенное мест., мн. ч., род. п.
PRPD	неопределенное мест., мн. ч., дат. п.
PRPA	неопределенное мест., мн. ч., вин. п., неодуш.
PRPU	неопределенное мест., мн. ч., вин. п., одуш.
PRPI	неопределенное мест., мн. ч., твор. п.
PRPR	неопределенное мест., мн. ч., предл. п.
PRAMO	неопред. мест-я от кто + неопред. местоимение некто (нет косв. пад.), м. р. только, им. п.
PRAMG	неопределенные местоимения от кто, м. р. только, род. п.
PRAMD	неопределенные местоимения от кто, м. р. только, дат. п.
PRAMA	неопределенные местоимения от кто, м. р. только, вин. п.
PRAMI	неопределенные местоимения от кто, м. р. только, твор. п.
PRAMR	неопределенные местоимения от кто, м. р. только, предл. п.
PRINO	неопред. мест-я от что + неопред. местоимение нечто (нет косв. пад.), ср. р. только, им. п.
PRING	неопределенные местоимения от что, ср. р. только, род. п.
PRIND	неопределенные местоимения от что, ср. р. только, дат. п.
PRINA	неопределенные местоимения от что, ср. р. только, вин. п.
PRINI	неопределенные местоимения от что, ср. р. только, твор. п.
PRINR	неопределенные местоимения от что, ср. р. только, предл. п.
PRPO	неопределенное мест. несколько, им. п.
PRPG	неопределенное мест. несколько, род. п.
PRPD	неопределенное мест. несколько, дат. п.
PRPA	неопределенное мест. несколько, вин. п., неодуш.
PRPU	неопределенное мест. несколько, вин. п., одуш.
PRPI	неопределенное мест. несколько, твор. п.
PRPR	неопределенное мест. несколько, предл. п.
RQ	наречие качества, образа действия
RQR	наречие качества (сравнительная степень)
RQT	наречие качества (превосходная степень)
RM	наречие количества, мера и степень
RT	наречие времени
RL	наречие места, направления
RV	наречие причины
RP	наречие цели
TC	частица
TP	частица постпозитивная
UH	междометие
VPC	глагол совершенного вида, инфинитив
VPIF1	глагол совершенного вида, изъяв. накл., буд. вр., 1-е л., ед. ч.
VPIF2	глагол совершенного вида, изъяв. накл., буд. вр., 2-е л., ед. ч.
VPIF3	глагол совершенного вида, изъяв. накл., буд. вр., 3-е л., ед. ч.
VPIF1P	глагол совершенного вида, изъяв. накл., буд. вр., 1-е л., мн. ч.
VPIF2P	глагол совершенного вида, изъяв. накл., буд. вр., 2-е л., мн. ч.
VPIF3P	глагол совершенного вида, изъяв. накл., буд. вр., 3-е л., мн. ч.
VPM1P	глагол совершенного вида, повелит. накл., 1-е л., мн. ч.
VPM2	глагол совершенного вида, повелит. накл., 2-е л., ед. ч.
VPM2P	глагол совершенного вида, повелит. накл., 2-е л., мн. ч.
VPIPM	глагол совершенного вида, изъяв. накл., пр. вр., м. р.
VPIPF	глагол совершенного вида, изъяв. накл., пр. вр., ж. р.
VPIPN	глагол совершенного вида, изъяв. накл., пр. вр., ср. р.
VPIPP	глагол совершенного вида, изъяв. накл., пр. вр., мн. ч.
VPB	деепричастие совершенного вида
VPLC	глагол совершенного вида, возвратный, инфинитив
VPLIF1	глагол совершенного вида, возвратный, изъяв. накл., буд. вр., 1-е л., ед. ч.
VPLIF2	глагол совершенного вида, возвратный, изъяв. накл., буд. вр., 2-е л., ед. ч.
VPLIF3	глагол совершенного вида, возвратный, изъяв. накл., буд. вр., 3-е л., ед. ч.
VPLIF1P	глагол совершенного вида, возвратный, изъяв. накл., буд. вр., 1-е л., мн. ч.
VPLIF2P	глагол совершенного вида, возвратный, изъяв. накл., буд. вр., 2-е л., мн. ч.
VPLIF3P	глагол совершенного вида, возвратный, изъяв. накл., буд. вр., 3-е л., мн. ч.
VPLM2	глагол совершенного вида, возвратный, повелит. накл., 2-е л., ед. ч.
VPLM2P	глагол совершенного вида, возвратный, повелит. накл., 2-е л., мн. ч.
VPLIPM	глагол совершенного вида, возвратный, изъяв. накл., пр. вр., м. р.
VPLIPF	глагол совершенного вида, возвратный, изъяв. накл., пр. вр., ж. р.
VPLIPN	глагол совершенного вида, возвратный, изъяв. накл., пр. вр., ср. р.
VPLIPP	глагол совершенного вида, возвратный, изъяв. накл., пр. вр., мн. ч.
VPLB	деепричастие совершенного вида, возвратное
VIC	глагол несовершенного вида, инфинитив
VIIR1	глагол несовершенного вида, изъяв. накл., наст. вр., 1-е л., ед. ч.
VIIR2	глагол несовершенного вида, изъяв. накл., наст. вр., 2-е л., ед. ч.
VIIR3	глагол несовершенного вида, изъяв. накл., наст. вр., 3-е л., ед. ч.
VIIR1P	глагол несовершенного вида, изъяв. накл., наст. вр., 1-е л., мн. ч.
VIIR2P	глагол несовершенного вида, изъяв. накл., наст. вр., 2-е л., мн. ч.
VIIR3P	глагол несовершенного вида, изъяв. накл., наст. вр., 3-е л., мн. ч.
VIM1P	глагол несовершенного вида, повелит. накл., 1-е л., мн. ч.
VIM2	глагол несовершенного вида, повелит. накл., 2-е л., ед. ч.
VIM2P	глагол несовершенного вида, повелит. накл., 2-е л., мн. ч.
VIIPM	глагол несовершенного вида, изъяв. накл., пр. вр., м. р.
VIIPF	глагол несовершенного вида, изъяв. накл., пр. вр., ж. р.
VIIPN	глагол несовершенного вида, изъяв. накл., пр. вр., ср. р.
VIIPP	глагол несовершенного вида, изъяв. накл., пр. вр., мн. ч.
VIB	деепричастие несовершенного вида
VILC	глагол несовершенного вида, возвратный, инфинитив
VILIR1	глагол несовершенного вида, возвратный, изъяв. накл., наст. вр., 1-е л., ед. ч.
VILIR2	глагол несовершенного вида, возвратный, изъяв. накл., наст. вр., 2-е л., ед. ч.
VILIR3	глагол несовершенного вида, возвратный, изъяв. накл., наст. вр., 3-е л., ед. ч.
VILIR1P	глагол несовершенного вида, возвратный, изъяв. накл., наст. вр., 1-е л., мн. ч.
VILIR2P	глагол несовершенного вида, возвратный, изъяв. накл., наст. вр., 2-е л., мн. ч.
VILIR3P	глагол несовершенного вида, возвратный, изъяв. накл., наст. вр., 3-е л., мн. ч.
VILM2	глагол несовершенного вида, возвратный, повелит. накл., 2-е л., ед. ч.
VILM2P	глагол несовершенного вида, возвратный, повелит. накл., 2-е л., мн. ч.
VILIPM	глагол несовершенного вида, возвратный, изъяв. накл., пр. вр., м. р.
VILIPF	глагол несовершенного вида, возвратный, изъяв. накл., пр. вр., ж. р.
VILIPN	глагол несовершенного вида, возвратный, изъяв. накл., пр. вр., ср. р.
VILIPP	глагол несовершенного вида, возвратный, изъяв. накл., пр. вр., мн. ч.
VILB	деепричастие несовершенного вида, возвратное
VMC	безличный глагол, инфинитив
VMIF3	безличный глагол, изъяв. накл., буд. вр., 3-е л., ед. ч.
VMIF3P	безличный глагол, изъяв. накл., буд. вр., 3-е л., мн. ч.
VMIR3	безличный глагол, изъяв. накл., наст. вр., 3-е л., ед. ч.
VMIR3P	безличный глагол, изъяв. накл., наст. вр., 3-е л., мн. ч.
VMIPN	безличный глагол, изъяв. накл., пр. вр., ср. р.
VMIPP	безличный глагол, изъяв. накл., пр. вр., мн. ч.
VMLC	безличный глагол, возвратный, инфинитив
VMLIF3	безличный глагол, возвратный, изъяв. накл., буд. вр., 3-е л., ед. ч.
VMLIF3P	безличный глагол, возвратный, изъяв. накл., буд. вр., 3-е л., мн. ч.
VMLIR3	безличный глагол, возвратный, изъяв. накл., наст. вр., 3-е л., ед. ч.
VMLIR3P	безличный глагол, возвратный, изъяв. накл., наст. вр., 3-е л., мн. ч.
VMLIPN	безличный глагол, возвратный, изъяв. накл., пр. вр., ср. р.
VMLIPP	безличный глагол, возвратный, изъяв. накл., пр. вр., мн. ч.
WD	вводное слово
XNOT	отрицательная частица
ZZ	одиночная буква / символ